NO texture/mossy.png
SO texture/redbrick.png
EA texture/mossy.png
WE texture/redbrick.png

F 120,120,120
C 102,255,255
111111111111111
111111S00111111
111110000011111
111100000001111
111000000000111
110000000000011
100001111100001
110000111000011
111000010000111
111100000001111
111110000011111
111111000111111
111111111111111

