NO texture/greenlight.png
SO texture/colorstone.png
EA texture/bluestone.png
WE texture/pminialg.png

F 20,20,20
C 200,200,200

111111
100001
100001
110001
10N111
111111