NO texture/barrel.png
SO texture/barrel.png
EA texture/barrel.png
WE texture/pminialg.png

F 20,20,20
C 200,200,200

1111111111
1111001001
1110000001
11000000E1
1110000001
1111000001
1111111111