NO texture/barrel.png
SO texture/greenlight.png
EA texture/purplestone.png
WE texture/pminialg.png

F 20,20,20
C 200,200,200

                            1111111111111111111111
                          11111001001001001000001
                        11101100000100000000111111
                        10010010011111011111
                        1001111000001001001
                        10000000N0000001001
                        1001111111111001001
                        1111000000000001011
                        1000000001000000001
                        1111111111111111111