NO texture/barrel.png
SO texture/greenlight.png
EA texture/purplestone.png
WE texture/pminialg.png

F 20,20,20
C 200,200,200

1111111111111111111
1001001001001000001
1011000001000000001
1001001001111101111
1001111000001001001
10000000N0000001001
1001111111111001001
1111000000000001011
1000000001000000001
1111111111111111111