NO texture/barrel.png
SO texture/greenlight.png
EA texture/purplestone.png
WE texture/pminialg.png

F 20,20,20
C 200,210,255

111111111111111111111111111111111111111111111111111111111111111111111111111111111111111111111111
100000000000000000000000000001000000000000000000000000000000000000000000000000000000000000000001
100000000000000000000000000001000000000000000000000000000000000000000000000000000000000000000001
100000000000000000000000000001000000000000000000000000000000000000000000000000000000000000000001
100000000000000000000000000001000000000000000000000000000000000000000000000000000000000000000001
100000000000000000000000000001000000000000000000000000000000000000000000000000000000000000000001
100000000000000000000000000001000000000000000000000000000000000000000000000000000000000000000001
100000000000000000000000000001000000000000000000000000000000000000000000000000000000000000000001
100000000000000000000000000000000000000000000000000000000100000000000000000000000000000000000001
100000000000000000000000000000000000000000000000000000000100000000000000000000000000000000000001
100000000000000001000000000000000000000000000000000000000100000000000000000000000000000000000001
100000000000000001000000000000000000000000000000000000000100000000000000000000000000000000000001
100000000000000001000000000000000000000000000000000000000100000000000000000000000000000000000001
10000000000000000100000000000000000000000000000000000000010W000000000000000000000000000000000001
100000000000000001000000000000000000000000000000000000000100000000000000000000000000000000000001
100000000000000001000000000000000000000000000000000000000000000000000000000000000000000000000001
100000000000000001000000010100000000000000000000000000000000000000000000000000000000000000000001
100000000000000000000000010100000000000000000000000000000000000000000000000000000000000000000001
100000000000000000000000010100000000000000000000100000000000000000000000000000000000000000000001
100000000000000000000000010100000000000000000000010000000000000000000000000000000000000000000001
100000000000000000000000010100000000000000000000001000000000000000000000000000000000000000000001
100000000000000000000000010100000000000000000000000100000000000000000000000000000000000000000001
100000000000000000000000010100000000000000000000000000000000000000000000000000000000000000000001
100000000000000000000000000000000000000000000000000000000000000000000000000000000000000000000001
100000000000000000000000000000000000000000000000000000000000000000000000000000000000000000000001
100000000000000000000000000000000000000000000000000000000000000000000000000000000000000000000001
100000000000000000000000000000000000000000000000000000000000000000000000000000000000000000000001
100000000000000000000000000000000000000000000000000000000000000000000000000000000000000000000001
100000000000000000000000000000000000000000000000000000000000000000000000000000000000000000000001
111111111111111111111111111111111111111111111111111111111111111111111111111111111111111111111111